#######
#######
#.. op#
#  o  #
# # o #
#.   ##
#######