#######
#######
#.. op#
# #o  #
# # o #
#.   ##
#######